11111111111111111111
100200P0000000C000E1
11111111111111111111