11111111111111111111111
10010000000000000000001
10010111100000100000C01
1P0001E0000000111111111
10000111100000000000001
10001000001000000000001
10001000001C00000010001
11111000001111000010001
1C000000000000000010C01
11111111111111111111111