1111111111111111
100P0000C00000E1
1111111111111111